"a" = (/turf/solo,/area/dark)
"b" = (/turf/parede,/area)
"c" = (/turf/solo,/area)
"d" = (/turf/solo/start,/area)
"e" = (/obj/bola_luz,/turf/solo,/area/dark)

(1,1,1) = {"
ccccccccccccccccccccccccccccccccccccccccccccccccccaaaaaaaaaaaaaaaaaaaaaaaaa
bbbbbbbbbbbbbbbbbbbbbbbbbbbbbbbbbbbbbbbbbbbbbbbbbbaaaaaaaaaaaaaaaaaaaaaaaaa
bcccccccccccccccccccccccccccbccccccccccccccccccccbaaaaaaaaaaaaaaaaaaaaaaaaa
bcccccccccccccccccccccccccccbccccccccccccccccccccbaaaaaaaaaaaaaaaaaaaaaaaaa
bcbbbbbbbbbbbbbbbbbbbbbcccccbccccccccccccccccccccbaaaaaaaaaaaaaaaaaaaaaaaaa
bcbcccccccccccccccccccbcccccbccccccccccccccccccccbaaaaaaaaaaaaaaaaaaaaaaaaa
bcbcccccccccccccccccccbbbbbbbcccccccbbbbbbbbbbcccbaaaaaaaaaaaaaaaaaaaaaaaaa
bcbcccccccccccccccccccbcccccccccccccbccccccccbcccbaaaaaaaaaaaaaaaaaaaaaaaaa
bcbbbbbbbbbbbbbbbbccccbccccccccccccccccccccccbcccbaaaaaaaaaaaaaaaaaaaaaaaaa
bccccccccccccccccbcccccccccccccccccccccccccccbcccbaaaaaaaaaaaaaaaaaaaaaaaaa
bccccccccccccccccbccccccccccccccccccbccccccccbcccbaaaaaaaaaaaaaaaaaaaaaaaaa
bccccccccccccccccbccccbcccccccccccccbbbbbccccbcccbaaaaaaaaaaaaaaaaaaaaaaaaa
bccccccccccccccccbccccbcccccccccccccccccbccccbcccbaaaaaaaaaaaaaaaaaaaaaaaaa
bbbbbbbbbbbbbbbbbbccccbccccccccbbbbbbbbbbccccbcccbaaaaaaaaaaaaaaaaaaaaaaaaa
bcccccccccccccccccccccbbbbbbbbbbcccccccccccccbcccbaaaaaaaaaaaaaaaaaaaaaaaaa
bccccccccccccccccccccccccccccccbbbbbbbbbbbbbcbcccbaaaaaaaaaaaaaaaaaaaaaaaaa
bccccbbbbbbbbbbbcccccccccccccccccccccccccccccbcccbaaaaaaaaaaaaaaaaaaaaaaaaa
bccccbcccccccccbcccccbbbbbbbcccccccccccccccccbcccbaaaaaaaaaaaaaaaaaaaaaaaaa
bccccbcccccccccbcccccbcccccbccccbbbbbbbbbbbbbbcccbaaaaaaaaaaaaaaaaaaaaaaaaa
bccccbccbbbbbbbbcccccbcccccbccccbccccccccccccbcccbaaaaaaaaaaaaaaaaaaaaaaaaa
bccccbccbccccccbcccccbccdccbccccbccccccccccccbcccbaaaaaaaaaaaaaaaaaaaaaaaaa
bccccbccbccccccbcccccbcccccbccccbcbbbbbbbbbbbbcccbaaaaaaaaaaaaaaaaaaaaaaaaa
bccccbccbccccccbcccccbcccccbccccbcbccccccccccccccbaaaaaaaaaaaaaaaaaaaaaaaaa
bccccbccbccccccbcccccbbbcbbbccccbcbccccccccccccccbaaaaaaaaaaaaaaaaaaaaaaaaa
bccccbccbccbbbbbccccccccccccccccbcbccccccccccccccbaaaaaaaaaaaaaaaaaaaaaaaaa
bccccbccbccbccccccccccccccccccccbcbbbbbbbbbbbbbccbaaaaaaaaaaaaaaaaaaaaaaaaa
bccccbcccccbccccccccccccccccccccbccccccccccccccccbaaaaaaaaaaaaaaaaaaaaaaaaa
bbbbbbcccccbccccbbbbbbbbbbbbbcccbccccccccccccccccbaaaaaaaaaaaaaaaaaaaaaaaaa
bccccbcccccbccccbcccccccccccccbbbbbbbbbbbbbbbbbccbaaaaaaaaaaaaaaaaaaaaaaaaa
bccccbcccccbccccbcccccccccccccbcccccccccccccccbccbaaaaaaaaaaaaaaaaaaaaaaaaa
bccccbcccccbbbbbbcccccccccccccbbbbbbbbbbbbccccbccbaaaaaaaaaaaaaaaaaaaaaaaaa
bccccbcccccccccccccccccccccccccccccccccccbccccbccbaaaaaaaaaaaaaaaaaaaaaaaaa
bccccbcccccccccccccccccccccccccccccccccccbccccbccbaaaaaaaaaaaaaaaaaaeaaaaaa
bccccbbbbbbbbbbbbbbbbbbcccccbbbbbccccccccbccccbccbaaaaaaaaaaaaaaaaaaaaaaaaa
bccccbccccccccccccccccbcccccbcccbccccccccbccccbccbaaaaaaaaaaaaaaaaaaaaaaaaa
bccccbccbccccbccccccbcbcccccbcccbccccccccbccccbccbaaaaaaaaaaaaaaaaaaaaaaaaa
bccccbccbccccbbbbbbbbcbcccccbcccbccccccccbccccbccbaaaaaaaaaaaaaaaaaaaaaaaaa
bccccbccbbbbbbbcccccbcbcccccbccbbccbbbbbbbccccbccbaaaaaaaaaaaaaaaaaaaaaaaaa
bccccbccccccccbcccccccbcccccbccbcccccccccbccccbccbaaaaaaaaaaaaaaaaaaaaaaaaa
bcccccccccccccbcccccccbcccccbccbcccccccccbcccccccbaaaaaaaaaaaaaaaaaaaaaaaaa
bcccccccbbbbbbbcccccbcbcccccbccbcccccccccbcccccccbaaaaaaaaaaaaaeaaaaaaaaaaa
bccccbccbcccccbbbbbbbcbcccccbccbcbbbbbbccbcccccccbaaaaaaaaaaaaaaaaaaaaaaaaa
bccccbccbcccccccccccccbcccccbccbcbccccbccbbbbbbccbaaaaaaaaaaaaaaaaaaaaaaaaa
bccccbccbbbbbbbbbbbbbbbcccccbccbcbccccbccbcccccccbaaaaaaaaaaaaaaaaaaaaaaaaa
bccccbccccccccccccccccbcccccbccbcbccccbccbcccccccbaaaaaaaaaaaaaaaaaaaaaaaaa
bccccbbbbbbbbbbbbbbbbbbcccccbccbcbccccbccbcccccccbaaaaaaaaaaaaaaaaaaaaaaaaa
bcccccccccccccccccccccccccccbccbcbcccccccccccccccbaaaaaaaaaaaaaaaaaaaaaaaaa
bcccccccccccccccccccccccccccbccbbbcccccccccccccccbaaaaaaaaaaaaaaaaaaaaaaaaa
bcccccccccccccccccccccccccccbccccccccccccccccccccbaaaaaeaaaaaaaaaaaaaaaaaaa
bbbbbbbbbbbbbbbbbbbbbbbbbbbbbbbbbbbbbbbbbbbbbbbbbbaaaaaaaaaaaaaaaaaaaaaeaaa
"}
